                         X                 X               X
                                G          X             XXX
XXXXXXXXXXXXXXXX             XXXXXXXX              XXXX     
                                                            
                                                            
                                                           X
XXXXXXXXXXXXXX XXXXXXXXXXXXXXXXXXXXXXXXXXXXXXXXXXXXXXXXXXXXX
X    XXXXXXXXX          XXXXXXXXXXXXXX                     X
       X                XXXXXXXXXXXXXX                     X
 XXXXX X                                                    
  X    X                                                    
X X X XX                                                    
XSX X                                                       