                         X           X     X               X
                                G    X     X   XXXXX   X XXX
XXXXXXXX XXXXXXXXXXXXXXX     XXXXXXXXX             X XX     
                       XXXXXXX     X               X    X   
                                X  X               X     X  
                                X                       XX X
XXXXXXXXXXXXXXXXXXXXXXXXXXXXXXXXXXXXXXXXXXXXXXXXXXXXXXXXXX X
X    XXXXXXXXX          XXXXXXXXXXXXXX                X    X
                        XXXXXXXXXXXXXX                X XXXX
XX                                                    X     
                                                      XXX   
                                                            
S                                                           