                         X                 X               X
              GX                           X             XXX
XXXXXXXXXXXXXXXX             XXXXXXXX              XXXX     
                                                            
                                                            
                                                           X
XXXXX XXXXXXXXXXXXXXXXXXXXXXXXXXXXXXXXXXXXXXXXXXXXXXXXXXXXXX
XX       XXXXX          XXXXXXXXXXXXXX                     X
                        XXXXXXXXXXXXXX                     X
XX                               X   X               X      
                                 X X X              X  XXX  
X                                  X X              X X   XX
                                   X                X   X  S